1111111111111111111EE1
10000LLLL0000000100001
100000LLLLL0000L1L0001
10010001L00000LL111001
1001000100010000100001
10010001000100001000L1
I00100000L010000100LL1
I0010000LLD10000100111
111111111111000L1000L1
10000000000000LL100001
1000000L01111111100001
1L0000LLL1000000100111
10000000L100000000L0D1
100L00000000000LLLLLL1
10LLLLLL000100LLLLLLL1
1D0LLLL000010LLLLLLLL1
1111111111111111111111