11111111111111111EEEE1
1000000000000000100001
1000000000000000100001
1000000000000000100001
I000000000010000100001
I000000000010000100001
I000000000010000100001
I000000000010000100001
1111111111110000100001
1000000000000000100001
1000000000000000100001
1000000000000000100001
1000000000000000000001
1000000000000000000001
1000000000000000000001
1000000000000000000001
1111111111111111111111