111111111111111111111EF1
1000000LLLL0000000100001
1000000LLLLLL00000100001
100000001111L0000L1L0001
1000110011L00000LL111001
100011001100010000100001
I0001100000L010000100LL1
I00F110000LL010000100111
11111111111111000L1000L1
1000000000000000LL100001
1000000000000000LL100001
1000000LLLL1111111100001
1L0000LLLLL1000000100111
1000000000L100000000L001
100L0000000000000LLLLLL1
10LLLLLLL0000100LLLLLLL1
100LLLLLLL00010LLLLLLLL1
111111111111111111111111